###############
#C    %      C#
#  ####### #  #
#C #&  CC  #  #
#C ####### #  #
#C    % # X#X #
##### ####### #
#CC#     #CCCC#
#C&#### C######
#  #CC#&C# %  #
#  ## ####### #
#        C    #
#   #    C ####
#X% #    C   @#
###############