###############
#@       C  C #
#########%  C&#
# CC  C%#######
#  C ######  &#
#C   CCCC##   #
#C #######%   #
#X  C  #### C #
###### C  #####
# X C C  %#% &#
############C #
#&  C X  #### #
#     C###  C #
#C   C  C    X#
###############