###############
#C   & %#%   &#
## #######  ###
#C   X####  #X#
#C #######  # #
#C    ####CC# #
##### ####### #
#C #C  C #   C#
#C ### X # ## #
#C  ###### # %#
##  ###  ######
# % ##     %  #
# C #    C   C#
#CC&#  @     C#
###############