###############
#C #@      C  #
# ## # ## ## ##
# %  # C  #&  #
# ## #### #####
#C    # X #   #
##### #   #####
#   C ###    C#
#C #  #& ## ###
#### ##   %  X#
#X  C #########
####  #     C #
#C   # % C #  #
#   C #     C&#
###############