###############
#C  &   C  %  #
## #######    #
#C #%   X#    #
#C ####### #  #
#C ##### X##CC#
######## #### #
#%C## C  #&C  #
#CC## C########
#CC#  #  # % X#
#CC## #########
#  C# #   %  @#
#   #C   C    #
#% &#   C C   #
###############