###############
#@  C   % C   #
##### #### # &#
# C#  CCC# #CC#
#C # ##### ####
#C       # X  #
####### ##### #
#CX#%        C#
#C ## ### #####
#C #  #       #
#C ##&### #####
# C#### % # % #
#        C#   #
# &##   C # X #
###############